11111111111111111111111111111111
10000000000000000000000000000011
10000000000000000000000000000011
10000000000000000000000000000011
10000000001111100000000000000011
10000000001000010000000000000011
10000000001000010000001000000011
10000000001000010000001000000011
10000000001000010000000000000011
10000000001000010000000000000011
10000000000000000000000000000011
11111111111111111111111111111111